#######
#.....#
#.#.#.#
#.#.#.#
#.###.#
#.....#
#######