######
#....#
#.#.##
#..#.#
##.#.#
#....#
######